      ####
####### @#
#     $  #
#   $## $#
##$#...# #
 # $...  #
 # #. .  ##
 #   # #$ #
 #$  $    #
 #  #######
 ####
