############  
#..  #     ###
#..  # $  $  #
#..  #$####  #
#..      ##  #
#+.  # #  $ ##
###### ##$ $ #
  # $  $ $ $ #
  #    #     #
  ############
