    #######
    #  #  ####
##### $#$ #  ##
#.. #  #  #   #
#.. # $#$ #  $####
#.  #     #$  #  #
#..   $#  # $    #
#..@#  #$ #$  #  #
#.. # $#     $#  #
#.. #  #$$#$  #  ##
#.. # $#  #  $#$  #
#.. #  #  #   #   #
##. ####  #####   #
 ####  ####   #####

